333 333 333 333 333 333 333 333 333 333 333 333 333 333 333 333 333 333 333 333 333 333 333 333 333 333 333 333 333 333 333 333 333 333 333 333 333 333 333 333 333 333 333 333 333 333 333 333 333 333 333 333 333 333 333 333 333 333 333 333 333 333 333 333 333 333 333 333 333 333 333 333 333 333 333 333 333 333 333 333 333 333 333 333 333 333 333 333 333 333 333 333 333 333 333 333 333 333 333 333 
333 333 333 333 333 333 333 333 333 333 333 333 333 333 333 333 333 333 333 333 333 333 333 333 333 333 333 333 333 333 333 333 333 333 333 333 333 333 333 333 333 333 333 333 333 333 333 333 333 333 333 333 333 333 333 333 333 333 333 333 333 333 333 333 333 333 333 333 333 333 333 333 333 333 333 333 333 333 333 333 333 333 333 333 333 333 333 333 333 333 333 333 333 333 333 333 333 333 333 333 
333 333 333 333 333 333 333 333 333 333 333 333 333 333 333 333 333 333 333 333 333 333 333 333 333 333 333 333 333 333 333 333 333 333 333 333 333 333 333 333 333 333 333 333 333 333 333 333 333 333 333 333 333 333 333 333 333 333 333 333 333 333 333 333 333 333 333 333 333 333 333 333 333 333 333 333 333 333 333 333 333 333 333 333 333 333 333 333 333 333 333 333 333 333 333 333 333 333 333 333 
333 333 333 333 333 333 333 333 333 333 333 333 333 333 333 333 333 333 333 333 333 333 333 333 333 333 333 333 333 333 333 333 333 333 333 333 333 333 333 333 333 333 333 333 333 333 333 333 333 333 333 333 333 333 333 333 333 333 333 333 333 333 333 333 333 333 333 333 333 333 333 333 333 333 333 333 333 333 333 333 333 333 333 333 333 333 333 333 333 333 333 333 333 333 333 333 333 333 333 333 
333 333 333 333 333 333 333 333 333 333 333 333 333 333 333 333 333 333 333 333 333 333 333 333 333 333 333 333 333 333 333 333 333 333 333 333 333 333 333 333 333 333 333 333 333 333 333 333 333 333 333 333 333 333 333 333 333 333 333 333 333 333 333 333 333 333 333 333 333 333 333 333 333 333 333 333 333 333 333 333 333 333 333 333 333 333 333 333 333 333 333 333 333 333 333 333 333 333 333 333 
333 333 333 333 333 310 310 310 310 310 310 310 310 310 310 310 310 310 310 310 310 310 310 310 310 310 310 310 310 310 310 310 310 310 310 310 310 310 310 310 310 310 310 310 310 310 310 310 310 310 310 310 310 310 310 310 310 310 310 310 310 310 310 310 310 310 310 310 310 310 310 310 310 310 310 310 310 310 310 310 310 310 310 310 310 310 310 310 310 310 310 310 310 310 333 333 333 333 333 333 
333 333 333 333 333 290 2 2 2 2 2 2 2 2 2 2 2 2 2 2 2 2 2 2 2 2 2 2 2 2 2 2 2 2 2 2 2 2 2 2 2 2 2 2 2 2 2 2 2 2 2 2 2 2 2 2 2 2 2 2 2 2 2 2 2 2 2 2 2 2 2 2 2 2 2 2 2 2 2 2 2 2 2 2 2 2 2 2 2 2 2 2 2 279 333 333 333 333 333 333 
333 333 333 333 333 290 2 2 2 2 2 2 2 2 2 2 2 2 2 2 2 2 2 2 2 2 2 2 2 2 2 2 2 2 2 2 2 2 2 2 2 2 2 2 2 2 2 2 2 2 2 2 2 2 2 2 2 2 2 2 2 2 2 2 2 2 2 2 2 2 2 2 2 2 2 2 2 2 2 2 2 2 2 2 2 2 2 2 2 2 2 2 2 279 333 333 333 333 333 333 
333 333 333 333 333 290 2 2 2 2 2 2 2 2 2 2 2 2 2 2 2 2 2 2 2 2 2 2 2 2 2 2 2 2 2 2 2 2 2 2 2 2 2 2 2 2 2 2 2 2 2 2 2 2 2 2 2 2 2 2 2 2 2 2 2 2 2 2 2 2 2 2 2 2 2 2 2 2 2 2 2 2 2 2 2 2 2 2 2 2 2 2 2 279 333 333 333 333 333 333 
333 333 333 333 333 290 2 2 2 2 2 2 2 2 2 2 2 2 2 2 2 2 2 2 2 2 2 2 2 2 2 2 2 2 2 2 2 2 2 2 2 2 2 2 2 2 2 2 2 2 2 2 2 2 2 2 2 2 2 2 2 2 2 2 2 2 2 2 2 2 2 2 2 2 2 2 2 2 2 2 2 2 2 2 2 2 2 2 2 2 2 2 2 279 333 333 333 333 333 333 
333 333 333 333 333 290 2 2 2 2 2 2 2 2 2 2 2 2 2 2 2 2 2 2 2 2 2 2 2 2 2 2 2 2 2 2 2 2 2 2 2 2 2 2 2 2 2 2 2 2 2 2 2 2 2 2 2 2 2 2 2 2 2 2 2 2 2 2 2 2 2 2 2 2 2 2 2 2 2 2 2 2 2 2 2 2 2 2 2 2 2 2 2 279 333 333 333 333 333 333 
333 333 333 333 333 290 2 2 2 2 2 2 2 2 2 2 2 2 2 2 2 2 2 2 257 258 2 2 2 2 2 2 2 2 2 2 2 2 2 2 2 2 2 2 2 2 2 2 2 2 2 2 2 2 2 2 2 2 257 258 2 2 2 2 2 2 2 2 2 2 2 2 2 2 2 2 2 2 2 2 2 2 2 2 2 2 2 2 2 2 2 2 2 279 333 333 333 333 333 333 
333 333 333 333 333 290 2 2 2 2 2 2 2 2 2 2 2 2 2 2 2 2 2 2 267 268 2 2 2 2 2 2 2 2 2 2 2 2 2 2 2 2 2 2 2 2 2 2 2 2 2 2 2 2 2 2 2 2 267 268 2 2 2 2 2 2 2 2 2 2 2 2 2 2 2 2 2 2 2 2 2 2 2 2 2 2 2 2 2 2 2 2 2 279 333 333 333 333 333 333 
333 333 333 333 333 290 2 2 2 2 2 2 2 2 2 2 2 257 258 2 2 2 2 2 317 318 2 2 2 2 2 2 2 2 2 2 2 2 2 2 2 2 2 2 2 2 2 2 2 2 2 2 2 2 2 2 2 2 317 318 2 2 2 2 2 2 2 2 2 2 2 2 2 2 2 2 2 2 2 2 2 2 2 2 2 2 2 2 2 2 2 2 2 279 333 333 333 333 333 333 
333 333 333 333 333 290 2 2 2 2 2 2 2 2 2 2 2 267 268 2 2 2 2 2 2 2 2 2 2 2 2 2 2 2 2 2 2 2 2 2 2 2 2 2 2 2 2 2 2 2 2 2 2 2 2 2 2 2 2 2 2 2 2 2 2 2 2 2 2 2 2 2 2 2 2 2 2 2 2 2 2 2 2 2 2 2 2 2 2 2 2 2 2 279 333 333 333 333 333 333 
333 333 333 333 333 290 2 2 2 2 2 2 2 2 2 2 2 317 318 2 2 2 2 2 2 2 2 2 2 2 2 2 2 2 2 2 2 2 2 2 2 2 2 2 2 2 2 2 2 2 2 2 2 2 2 2 2 2 2 2 2 2 2 2 2 2 2 2 2 2 257 258 2 2 2 2 2 2 2 2 2 2 2 2 2 2 2 2 2 2 2 2 2 279 333 333 333 333 333 333 
333 333 333 333 333 290 2 2 2 2 2 2 2 2 2 2 2 2 2 2 2 2 2 2 2 2 2 2 2 2 2 2 2 2 2 2 2 2 2 2 257 258 2 2 2 2 2 2 2 2 2 2 2 2 2 2 2 2 2 2 2 2 2 2 2 2 2 2 2 2 267 268 2 2 2 2 2 2 2 2 2 2 2 2 2 2 2 2 2 2 2 2 2 279 333 333 333 333 333 333 
333 333 333 333 333 290 2 2 2 2 2 2 2 2 2 2 2 2 2 2 2 2 2 2 2 2 2 2 2 2 2 2 2 2 2 2 2 2 2 2 267 268 2 2 2 2 2 2 2 2 2 2 2 2 2 2 2 2 2 2 2 2 2 2 2 2 2 2 2 2 317 318 2 2 2 2 2 2 2 2 2 2 2 2 2 2 2 2 2 2 2 2 2 279 333 333 333 333 333 333 
333 333 333 333 333 290 2 2 2 2 2 2 2 2 2 2 2 2 2 2 2 2 2 2 2 2 2 2 2 2 2 2 2 2 2 2 2 2 2 2 317 318 2 2 2 2 2 2 2 2 2 2 2 2 2 2 2 2 2 2 2 2 2 2 2 2 2 2 2 2 2 2 2 2 2 2 2 2 2 2 2 2 2 2 2 2 2 2 2 2 2 2 2 279 333 333 333 333 333 333 
333 333 333 333 333 290 2 2 2 2 2 2 2 2 2 2 2 2 2 2 2 2 2 2 2 2 2 2 2 2 2 2 2 2 2 2 2 2 2 2 2 2 2 2 2 2 2 2 2 2 2 2 2 2 2 2 2 2 2 2 2 2 2 2 2 2 2 2 2 2 2 2 2 2 2 2 2 2 2 2 2 2 2 2 2 2 257 258 2 2 2 2 2 279 333 333 333 333 333 333 
333 333 333 333 333 290 2 2 2 2 2 2 257 258 2 2 2 2 2 2 2 2 2 2 2 2 2 2 2 2 257 258 2 2 2 2 2 2 2 2 2 2 2 2 2 2 2 2 257 258 2 2 2 2 2 2 2 2 2 2 2 2 2 2 2 2 2 2 2 2 2 2 2 2 2 2 2 2 2 2 2 2 2 2 2 2 267 268 2 2 2 2 2 279 333 333 333 333 333 333 
333 333 333 333 333 290 2 2 2 2 2 2 267 268 2 2 2 2 2 2 2 2 2 2 2 2 2 2 2 2 267 268 2 2 2 2 2 2 2 2 2 2 2 2 2 2 2 2 267 268 2 2 2 2 2 2 2 2 2 2 2 2 2 2 2 2 2 2 2 2 2 2 2 2 2 2 2 2 2 2 2 2 2 2 2 2 317 318 2 2 2 2 2 279 333 333 333 333 333 333 
333 333 333 333 333 290 2 2 2 2 2 2 317 318 2 2 2 2 2 2 2 2 2 2 2 2 2 2 2 2 317 318 2 2 2 2 2 2 2 2 2 2 2 2 2 2 2 2 317 318 2 2 2 2 2 2 2 2 2 2 2 2 2 2 2 2 2 2 2 2 2 2 2 2 2 2 2 2 2 2 2 2 2 2 2 2 2 2 2 2 2 2 2 279 333 333 333 333 333 333 
333 333 333 333 333 290 2 2 2 2 2 2 2 2 2 2 2 2 2 2 2 2 2 2 2 2 2 2 2 2 2 2 2 2 2 2 2 2 2 2 2 2 2 2 2 2 2 2 2 2 2 2 2 2 2 2 2 2 2 2 2 2 2 2 2 2 2 2 2 2 2 2 2 2 2 2 2 2 2 2 2 2 2 2 2 2 2 2 2 2 2 2 2 279 333 333 333 333 333 333 
333 333 333 333 333 290 2 2 2 2 2 2 2 2 2 2 2 2 2 2 2 2 2 2 2 2 2 2 2 2 2 2 2 2 2 2 2 2 2 2 2 2 2 2 2 2 2 2 2 2 2 2 257 258 2 2 2 2 2 2 2 2 2 2 2 2 2 2 2 2 257 258 2 2 2 2 2 2 2 2 2 2 2 2 2 2 2 2 2 2 2 2 2 279 333 333 333 333 333 333 
333 333 333 333 333 290 2 2 2 2 2 2 2 2 2 2 2 2 2 2 2 257 258 2 2 2 2 2 2 2 2 2 2 2 2 2 2 2 2 2 2 2 2 2 2 2 2 2 2 2 2 2 267 268 2 2 2 2 2 2 2 2 2 2 2 2 2 2 2 2 267 268 2 2 2 2 2 2 2 2 2 2 2 2 2 2 2 2 2 2 2 2 2 279 333 333 333 333 333 333 
333 333 333 333 333 290 2 2 2 2 2 2 2 2 2 2 2 2 2 2 2 267 268 2 2 2 2 2 2 2 2 2 2 2 2 2 2 2 257 258 2 2 2 2 2 2 2 2 2 2 2 2 317 318 2 2 2 2 2 2 2 2 2 2 2 2 2 2 2 2 317 318 2 2 2 2 2 2 2 257 258 2 2 2 2 2 2 2 2 2 2 2 2 279 333 333 333 333 333 333 
333 333 333 333 333 290 2 2 2 2 2 2 2 2 2 2 2 2 2 2 2 317 318 2 2 2 2 2 2 2 2 257 258 2 2 2 2 2 267 268 2 2 2 2 2 2 2 2 2 2 2 2 2 2 2 2 2 2 2 257 258 2 2 2 2 2 2 2 2 2 2 2 2 2 2 2 2 2 2 267 268 2 2 2 2 2 2 2 2 2 2 2 2 279 333 333 333 333 333 333 
333 333 333 333 333 290 2 2 2 2 2 2 2 2 2 2 2 2 2 2 2 2 2 2 2 2 2 2 2 2 2 267 268 2 2 2 2 2 317 318 2 2 2 2 2 2 2 2 2 2 2 2 2 2 2 2 2 2 2 267 268 2 2 2 2 2 2 2 2 2 2 2 2 2 2 2 2 2 2 317 318 2 2 2 2 2 2 2 2 2 2 2 2 279 333 333 333 333 333 333 
333 333 333 333 333 290 2 2 2 2 2 2 2 2 2 2 2 2 2 2 2 2 2 2 2 2 2 2 2 2 2 317 318 2 2 2 2 2 2 2 2 2 2 2 2 2 2 2 2 2 2 2 2 2 2 2 2 2 2 317 318 2 2 2 2 2 2 2 2 2 2 2 2 2 2 2 2 2 2 2 2 2 2 2 2 2 2 2 2 2 2 2 2 279 333 333 333 333 333 333 
333 333 333 333 333 290 2 2 2 2 2 2 2 2 2 2 2 2 2 2 2 2 2 2 2 2 2 2 2 2 2 2 2 2 2 2 2 2 2 2 2 2 2 2 2 2 2 2 2 2 2 2 2 2 2 2 2 2 2 2 2 2 2 2 2 2 2 2 2 2 2 2 2 2 2 2 2 2 2 2 2 2 2 2 2 2 2 2 2 2 2 2 2 279 333 333 333 333 333 333 
333 333 333 333 333 290 2 2 2 2 2 2 2 2 2 2 2 2 2 2 2 2 2 2 2 2 2 2 2 2 2 2 2 2 2 2 2 2 2 2 2 2 2 2 2 2 2 2 2 2 2 2 2 2 2 2 2 2 2 2 2 2 2 2 2 2 2 2 2 2 2 2 2 2 2 2 2 2 2 2 2 2 2 2 2 257 258 2 2 2 2 2 2 279 333 333 333 333 333 333 
333 333 333 333 333 290 2 2 2 2 2 2 2 2 2 2 2 2 2 2 2 2 2 2 2 2 2 2 2 2 2 2 2 257 258 2 2 2 2 257 258 2 2 2 2 2 2 2 2 2 2 2 2 2 2 2 2 2 2 2 2 2 2 2 2 2 2 2 2 2 2 2 2 2 2 2 2 2 2 2 2 2 2 2 2 267 268 2 2 2 2 2 2 279 333 333 333 333 333 333 
333 333 333 333 333 290 2 2 2 2 2 2 2 2 257 258 2 2 2 2 2 2 2 2 2 2 2 2 2 2 2 2 2 267 268 2 2 2 2 267 268 2 2 2 2 2 2 2 2 2 2 2 2 2 2 2 2 2 2 2 2 2 2 2 2 2 2 2 2 2 2 2 2 2 2 2 2 2 2 2 2 2 2 2 2 317 318 2 2 2 2 2 2 279 333 333 333 333 333 333 
333 333 333 333 333 290 2 2 2 2 2 2 2 2 267 268 2 2 2 2 2 2 2 2 2 2 2 2 2 2 2 2 2 317 318 2 2 2 2 317 318 2 2 2 2 2 2 2 2 2 2 2 2 2 2 2 2 2 2 2 2 2 2 2 2 2 2 2 2 2 2 2 2 2 2 2 2 2 2 2 2 2 2 2 2 2 2 2 2 2 2 2 2 279 333 333 333 333 333 333 
333 333 333 333 333 290 2 2 2 2 2 2 2 2 317 318 2 2 2 2 2 2 2 2 2 2 2 2 2 2 2 2 2 2 2 2 2 2 2 2 2 2 2 2 2 2 2 2 2 2 2 2 2 2 2 2 2 2 2 2 2 2 2 2 2 2 2 2 2 2 2 257 258 2 2 2 2 2 2 2 2 2 2 2 2 2 2 2 2 2 2 2 2 279 333 333 333 333 333 333 
333 333 333 333 333 290 2 2 2 2 2 2 2 2 2 2 2 2 2 2 2 2 2 257 258 2 2 2 2 2 2 2 2 2 2 2 2 2 2 2 2 2 2 2 2 2 257 258 2 2 2 2 2 257 258 2 2 2 2 2 2 2 2 2 2 2 2 2 2 2 2 267 268 2 2 2 2 2 2 2 2 2 2 2 2 2 2 2 2 2 2 2 2 279 333 333 333 333 333 333 
333 333 333 333 333 290 2 2 2 2 2 2 2 2 2 2 2 2 2 2 2 2 2 267 268 2 2 2 2 2 2 2 2 2 2 2 2 2 2 2 2 2 2 2 2 2 267 268 2 2 2 2 2 267 268 2 2 2 2 2 2 2 257 258 2 2 2 2 2 2 2 317 318 2 2 2 2 2 2 2 2 2 2 2 2 2 2 2 2 2 2 2 2 279 333 333 333 333 333 333 
333 333 333 333 333 290 2 2 2 2 2 2 2 2 2 2 2 2 2 2 2 2 2 317 318 2 2 2 2 2 2 2 2 2 2 2 2 2 2 2 2 2 2 2 2 2 317 318 2 2 2 2 2 317 318 2 2 2 2 2 2 2 267 268 2 2 2 2 2 2 2 2 2 2 2 2 2 2 2 2 2 2 2 2 2 2 2 2 2 257 258 2 2 279 333 333 333 333 333 333 
333 333 333 333 333 290 2 2 2 2 2 2 2 2 2 2 2 2 2 2 2 2 2 2 2 2 2 2 2 2 2 2 2 2 2 2 2 2 2 2 2 2 2 2 2 2 2 2 2 2 2 2 2 2 2 2 2 2 2 2 2 2 317 318 2 2 2 2 2 2 2 2 2 2 2 2 2 2 257 258 2 2 2 2 2 2 2 2 2 267 268 2 2 279 333 333 333 333 333 333 
333 333 333 333 333 290 2 2 2 2 2 2 2 2 2 2 2 2 2 2 2 2 2 2 2 2 2 2 2 2 2 2 2 257 258 2 2 2 2 2 2 2 2 2 2 2 2 2 2 2 2 2 2 2 2 2 2 2 2 2 2 2 2 2 2 2 2 2 2 2 2 2 2 2 2 2 2 2 267 268 2 2 2 2 2 2 2 2 2 317 318 2 2 279 333 333 333 333 333 333 
333 333 333 333 333 290 2 2 2 2 2 2 2 2 2 2 2 2 2 2 2 2 2 2 2 2 2 2 2 2 2 2 2 267 268 2 2 2 2 2 2 2 2 2 2 2 2 2 2 2 2 2 2 2 2 2 2 2 2 2 2 2 2 2 2 2 2 2 2 2 2 2 2 2 2 2 2 2 317 318 2 2 2 2 2 2 2 2 2 2 2 2 2 279 333 333 333 333 333 333 
333 333 333 333 333 290 2 2 2 2 2 2 2 2 2 2 2 2 2 2 2 2 2 2 2 2 2 2 2 2 2 2 2 317 318 2 2 2 1133 2 2 2 2 2 2 2 2 2 2 2 2 2 2 2 2 2 2 2 2 2 2 2 2 2 2 2 2 2 2 2 2 2 2 2 2 2 2 2 2 2 2 2 2 2 2 2 2 2 2 2 2 2 2 279 333 333 333 333 333 333 
333 333 333 333 333 290 2 2 2 2 2 2 2 2 2 2 2 2 2 2 2 2 2 2 2 257 258 2 2 2 2 2 2 2 2 2 2 2 2 2 2 2 2 2 2 2 2 2 2 2 2 2 2 2 2 2 2 2 2 2 2 2 2 2 2 2 2 2 2 2 2 2 2 2 2 2 2 2 2 2 2 2 2 2 2 2 2 2 2 2 2 2 2 279 333 333 333 333 333 333 
333 333 333 333 333 290 2 2 2 2 2 2 2 2 2 2 2 2 2 2 2 2 2 2 2 267 268 2 2 2 2 2 2 2 2 2 2 2 2 173 2 2 2 2 2 2 2 2 2 2 2 2 2 2 2 2 2 2 2 2 2 2 2 2 2 2 2 2 2 2 2 2 2 2 2 2 2 2 2 2 2 2 2 2 2 2 2 2 2 2 2 2 175 279 333 333 333 333 333 333 
333 333 333 333 333 290 2 2 2 2 2 2 2 2 2 2 2 2 2 2 2 2 2 2 2 317 318 2 2 2 2 2 2 2 2 2 2 2 2 2 2 2 2 2 2 2 2 2 2 2 2 2 2 2 2 2 2 2 2 2 2 2 2 2 2 2 2 2 2 2 2 2 2 2 2 2 2 2 2 2 2 2 2 2 2 2 2 2 2 2 2 2 2 279 333 333 333 333 333 333 
333 333 333 333 333 290 2 2 2 2 2 2 2 2 2 2 257 258 2 2 2 2 2 2 2 2 2 2 2 2 2 2 2 2 2 2 2 2 2 2 2 2 2 2 2 2 2 2 2 2 2 2 2 2 2 2 2 2 2 2 2 2 2 2 2 2 2 2 2 2 2 2 2 2 2 2 2 2 2 2 2 2 2 2 2 2 2 2 2 2 2 2 2 279 333 333 333 333 333 333 
333 333 333 333 333 290 2 2 2 2 2 2 2 2 2 2 267 268 2 2 2 2 2 2 2 2 2 2 2 2 2 2 2 2 2 1133 2 2 2 2 2 2 2 2 2 2 2 2 2 2 2 2 2 2 2 2 2 2 2 2 2 2 2 2 2 2 2 2 2 2 2 2 2 2 2 2 2 2 2 2 2 2 2 2 2 2 2 2 2 2 2 2 2 279 333 333 333 333 333 333 
333 333 333 333 333 290 2 2 2 2 2 2 2 2 2 2 317 318 2 2 2 2 2 2 2 2 2 2 2 2 2 2 2 2 2 2 2 2 2 2 2 2 2 2 2 2 2 2 2 2 2 2 2 2 2 2 2 2 2 2 2 2 2 2 2 2 2 2 2 2 2 2 2 2 2 2 2 2 2 2 2 2 2 2 2 2 2 2 2 2 2 2 2 279 333 333 333 333 333 333 
333 333 333 333 333 290 2 2 2 2 2 2 2 2 2 2 2 2 2 2 2 2 2 2 2 2 2 2 2 2 2 2 2 2 2 2 2 2 2 2 2 2 2 2 2 2 2 2 2 2 2 2 2 2 2 2 2 2 2 2 2 2 2 2 2 2 2 2 2 2 2 2 2 2 2 2 2 2 2 2 2 2 2 2 2 2 2 2 2 2 2 2 2 279 333 333 333 333 333 333 
333 333 333 333 333 290 2 2 2 2 2 2 2 2 2 2 2 2 2 2 2 2 2 2 2 2 2 2 2 2 2 257 258 2 2 2 2 2 2 2 2 2 2 2 2 2 2 2 2 2 2 2 2 2 2 2 2 2 2 2 2 2 2 2 2 2 2 2 2 2 2 2 2 2 2 2 2 2 2 2 2 2 2 2 2 2 2 2 2 2 2 2 2 279 333 333 333 333 333 333 
333 333 333 333 333 290 2 2 2 2 2 2 2 2 2 2 2 2 2 2 2 2 2 2 2 2 2 2 2 2 2 267 268 2 2 2 2 2 2 2 2 2 2 2 2 2 2 2 2 2 2 2 2 2 2 2 2 2 2 2 2 2 2 2 2 2 2 2 2 2 2 2 2 2 2 2 2 2 2 2 2 2 2 2 2 2 2 2 2 2 2 2 195 279 333 333 333 333 333 333 
333 333 333 333 333 290 2 2 2 2 2 2 2 2 2 2 2 2 2 2 2 2 2 2 2 2 2 2 2 2 2 317 318 2 2 2 2 2 2 2 2 2 2 2 2 2 2 2 2 2 2 2 2 2 2 2 2 2 2 2 2 2 2 2 2 2 2 2 2 2 2 2 2 2 2 2 2 2 2 2 2 2 2 2 2 2 2 2 2 2 2 2 2 279 333 333 333 333 333 333 
333 333 333 333 333 290 2 2 2 2 2 2 2 2 2 2 2 2 2 2 2 2 2 2 2 2 2 2 2 2 2 2 2 2 2 2 2 2 2 2 2 2 2 2 2 2 2 2 2 2 2 2 2 2 2 2 2 2 2 2 1133 2 2 2 2 2 2 2 2 2 2 2 2 2 2 2 2 2 2 2 2 2 2 2 2 2 2 2 2 2 2 2 2 279 333 333 333 333 333 333 
333 333 333 333 333 290 2 2 2 2 2 2 2 2 2 2 2 2 2 2 2 2 2 2 2 2 2 2 2 2 2 2 2 2 2 2 2 2 2 2 2 2 2 2 2 2 2 2 2 2 2 2 2 2 2 2 2 2 2 2 2 2 2 2 2 2 2 2 2 2 2 2 2 2 2 2 2 2 2 2 2 2 672 673 674 2 2 2 2 2 2 2 2 279 333 333 333 333 333 333 
333 333 333 333 333 290 2 2 2 2 2 2 2 2 2 2 2 2 2 2 2 2 2 2 2 2 2 2 2 2 2 2 2 2 2 2 2 2 2 2 2 2 2 2 2 2 2 2 2 2 2 2 2 1133 2 2 2 2 2 2 2 2 2 2 2 2 2 2 2 2 2 2 2 2 2 2 2 2 2 2 2 2 682 683 684 2 2 2 2 2 2 2 2 279 333 333 333 333 333 333 
333 333 333 333 333 290 2 2 2 2 2 2 2 2 2 2 2 2 2 2 2 2 2 2 2 2 2 2 2 2 2 2 2 2 2 2 2 2 2 2 2 2 2 2 2 2 2 2 2 2 2 2 2 2 2 2 2 2 2 2 2 2 2 2 2 2 257 258 2 2 2 2 2 2 2 2 2 2 2 2 2 2 2 2 2 2 2 2 2 2 2 2 2 279 333 333 333 333 333 333 
333 333 333 333 333 290 2 2 2 2 2 2 2 2 2 2 257 258 2 2 2 2 2 2 2 2 2 2 2 2 2 1133 2 2 2 2 2 2 2 2 2 2 2 2 2 2 2 2 2 2 2 2 2 2 2 2 2 2 2 2 2 2 2 2 2 2 267 268 2 2 2 2 2 2 2 2 2 2 2 2 2 2 2 2 2 2 2 2 2 2 2 2 2 279 333 333 333 333 333 333 
333 333 333 333 333 290 2 2 2 2 2 2 2 2 2 2 267 268 2 2 2 2 2 2 257 258 2 2 2 2 2 2 2 2 2 2 2 2 2 2 2 2 2 2 2 2 2 2 2 2 2 2 2 2 2 2 2 2 2 2 2 2 2 2 2 2 317 318 2 2 2 2 2 2 2 2 2 1133 2 2 2 2 2 2 2 2 2 2 2 2 2 2 2 279 333 333 333 333 333 333 
333 333 333 333 333 290 2 2 2 2 2 2 2 2 2 2 317 318 2 2 2 2 2 2 267 268 2 2 2 2 2 2 2 2 2 2 2 2 2 2 2 2 2 2 2 2 2 2 2 2 2 2 1133 2 2 2 2 2 2 2 2 2 2 2 2 2 2 1133 2 2 2 2 2 2 2 2 2 2 2 2 2 2 2 2 2 2 2 2 2 2 2 2 2 279 333 333 333 333 333 333 
333 333 333 333 333 290 2 2 2 2 2 2 2 2 2 2 2 2 2 2 2 2 2 2 317 318 2 2 2 2 2 2 2 2 2 2 2 2 2 2 2 2 2 2 2 2 2 2 2 2 2 2 2 2 2 2 672 673 674 2 2 2 2 2 2 2 2 2 2 2 2 2 2 2 2 2 2 2 2 2 2 2 2 2 2 2 2 2 2 2 2 2 2 279 333 333 333 333 333 333 
333 333 333 333 333 290 2 2 2 2 2 2 2 2 2 2 2 2 2 2 2 2 2 2 2 2 2 2 2 2 2 257 258 2 2 2 2 2 2 2 2 2 2 2 2 2 2 2 2 2 2 2 2 2 2 2 682 683 684 2 2 2 2 2 2 2 2 2 2 2 2 2 2 2 2 2 2 2 2 2 2 2 2 2 2 2 2 2 2 2 2 2 2 279 333 333 333 333 333 333 
333 333 333 333 333 290 2 2 2 2 2 2 2 2 2 2 2 2 2 2 2 2 2 2 2 2 2 2 2 2 2 267 268 2 2 2 2 2 2 2 2 2 2 2 2 2 2 2 2 2 2 2 2 2 2 2 2 2 2 2 2 2 2 2 2 2 2 2 2 2 2 2 2 2 2 2 2 2 2 2 2 2 2 2 2 2 2 2 2 2 2 2 2 279 333 333 333 333 333 333 
333 333 333 333 333 290 2 2 2 2 2 2 2 2 2 2 2 2 2 2 2 2 2 2 2 2 2 2 2 2 2 317 318 2 2 2 2 2 2 2 2 2 2 2 2 2 2 2 2 2 2 2 2 2 2 2 2 2 2 2 2 2 2 2 2 2 2 2 2 2 2 2 2 2 2 2 2 2 2 2 2 2 2 2 2 2 2 2 2 2 2 2 2 279 333 333 333 333 333 333 
333 333 333 333 333 290 2 2 2 2 2 2 2 2 2 2 2 2 2 2 2 2 2 2 2 2 2 2 2 2 2 2 2 2 2 2 2 2 2 2 2 2 2 2 2 2 2 2 2 2 2 2 2 2 2 2 2 2 2 2 2 2 2 2 2 2 2 2 2 2 2 2 2 2 2 2 2 2 2 2 2 2 2 2 2 2 2 2 2 2 2 2 2 279 333 333 333 333 333 333 
333 333 333 333 333 290 2 2 2 2 2 2 2 2 2 2 2 2 2 2 2 257 258 2 2 2 2 2 2 2 2 2 2 2 2 2 2 2 2 2 2 2 2 2 2 2 2 2 2 2 2 2 2 2 2 2 2 2 2 2 2 2 2 2 2 2 2 2 2 2 2 2 2 2 2 2 2 2 2 2 2 2 2 2 2 2 2 2 2 2 2 2 2 279 333 333 333 333 333 333 
333 333 333 333 333 290 2 2 2 2 2 2 2 2 2 2 2 2 2 2 2 267 268 2 2 2 2 2 2 2 2 2 2 2 2 2 2 2 2 2 2 2 2 2 2 2 2 2 2 2 2 2 2 1133 2 2 2 2 2 2 2 2 2 2 2 2 2 2 2 2 1133 2 2 2 2 2 2 257 258 2 2 2 2 2 2 2 2 2 2 2 2 2 2 279 333 333 333 333 333 333 
333 333 333 333 333 290 2 257 258 2 2 2 2 2 2 2 2 2 2 2 2 317 318 2 2 2 2 2 2 2 2 2 2 2 2 2 2 2 2 2 2 2 2 2 2 2 2 2 2 2 2 2 2 2 2 2 2 2 2 2 2 2 2 2 2 2 2 2 2 2 2 2 2 2 2 2 2 267 268 2 2 2 2 2 2 2 2 2 2 2 2 2 2 279 333 333 333 333 333 333 
333 333 333 333 333 290 2 267 268 2 2 2 2 2 2 2 2 2 2 2 2 2 2 2 2 2 2 2 2 2 2 2 2 2 2 1133 2 2 2 2 2 2 2 2 2 2 2 2 2 2 2 2 2 2 2 2 2 2 2 2 2 2 2 2 2 2 2 2 2 2 2 2 2 2 2 2 2 317 318 2 2 2 2 2 2 2 2 2 2 2 2 2 2 279 333 333 333 333 333 333 
333 333 333 333 333 290 2 317 318 2 2 2 2 2 2 2 2 2 2 2 2 2 2 2 2 2 2 2 2 2 2 2 2 2 2 2 2 2 2 2 2 2 2 2 2 2 2 2 2 2 2 2 2 2 2 1133 2 2 2 2 2 257 258 2 2 2 2 2 2 2 2 2 2 2 2 2 2 2 2 2 2 2 2 2 2 2 2 2 2 2 2 2 2 279 333 333 333 333 333 333 
333 333 333 333 333 290 2 2 2 2 2 2 2 2 2 2 2 2 2 2 2 2 2 2 2 2 2 2 2 2 2 2 2 2 2 2 2 2 2 2 2 2 2 2 2 2 2 2 2 2 2 2 2 2 2 2 2 2 2 2 2 267 268 2 2 2 2 2 2 2 2 2 2 2 2 2 2 2 2 2 2 2 2 2 2 2 2 2 2 2 2 2 2 279 333 333 333 333 333 333 
333 333 333 333 333 290 2 2 2 2 2 2 2 2 2 2 2 2 2 2 2 2 2 2 2 2 257 258 2 2 2 2 2 2 2 2 2 2 2 2 2 2 2 2 2 2 2 2 2 2 2 2 2 2 2 2 2 2 2 2 2 317 318 2 2 2 2 2 2 2 2 2 2 2 2 2 2 2 2 2 2 2 2 2 2 2 2 2 2 2 2 2 2 279 333 333 333 333 333 333 
333 333 333 333 333 290 2 2 2 2 2 2 2 257 258 2 2 2 2 2 2 2 2 2 2 2 267 268 2 2 2 2 2 2 2 2 2 2 2 2 2 2 2 2 2 2 2 2 2 2 2 2 2 2 2 2 2 2 2 2 2 2 2 2 2 2 2 2 2 2 2 2 2 2 2 2 2 2 2 2 2 2 2 2 2 2 2 2 2 2 2 2 2 279 333 333 333 333 333 333 
333 333 333 333 333 290 2 2 2 2 2 2 2 267 268 2 2 2 2 2 2 2 2 2 2 2 317 318 2 2 2 2 2 2 2 2 2 2 2 2 2 2 2 2 2 2 2 2 2 2 2 2 2 2 2 2 2 2 2 2 2 2 2 2 2 2 2 2 2 2 2 2 2 2 2 2 2 2 2 2 2 2 2 2 2 2 2 2 2 2 2 2 2 279 333 333 333 333 333 333 
333 333 333 333 333 290 2 2 2 2 2 2 2 317 318 2 2 2 2 2 2 2 2 2 2 2 2 2 2 2 2 2 2 2 2 2 2 2 2 2 2 2 2 2 2 2 2 2 2 2 2 2 2 2 2 2 2 2 2 2 2 2 2 2 2 2 2 2 2 2 2 672 673 674 2 2 2 2 2 2 2 2 2 2 2 2 2 2 2 2 2 2 2 279 333 333 333 333 333 333 
333 333 333 333 333 290 2 2 2 2 2 2 2 2 2 2 2 2 2 2 2 2 2 2 2 2 2 2 2 2 2 2 2 2 2 2 2 2 2 2 2 2 2 2 2 2 2 2 2 2 2 2 2 2 2 2 2 2 2 2 2 2 2 2 2 2 2 2 2 2 2 682 683 684 2 2 2 2 2 2 2 2 2 2 2 2 2 2 2 2 2 2 2 279 333 333 333 333 333 333 
333 333 333 333 333 290 2 2 2 2 2 2 2 2 2 2 2 2 2 2 2 2 2 2 2 2 2 2 2 2 2 2 2 2 2 2 2 2 2 2 2 2 2 2 2 2 2 2 2 2 2 2 2 2 2 2 2 2 2 2 2 2 2 257 258 2 2 2 2 2 2 2 2 2 2 2 2 2 2 2 2 2 2 2 2 2 2 2 2 2 2 2 2 279 333 333 333 333 333 333 
333 333 333 333 333 290 2 2 2 2 2 2 2 2 2 2 2 2 2 2 2 257 258 2 2 2 2 2 2 2 2 2 2 2 257 258 2 2 2 2 2 2 2 2 2 2 2 2 2 2 2 2 2 2 2 2 2 2 2 2 2 2 2 267 268 2 2 2 2 2 2 2 2 2 2 2 2 2 2 2 2 2 2 2 2 2 2 2 2 2 2 2 2 279 333 333 333 333 333 333 
333 333 333 333 333 290 2 2 2 2 2 2 2 2 2 2 2 2 2 2 2 267 268 2 2 2 2 2 2 2 2 2 2 2 267 268 2 2 2 2 2 2 2 2 2 2 2 2 2 2 2 2 2 2 2 2 2 2 2 2 2 2 2 317 318 2 2 2 2 2 2 2 2 2 2 2 2 2 2 2 2 2 2 2 2 257 258 2 2 2 2 2 2 279 333 333 333 333 333 333 
333 333 333 333 333 290 2 2 2 2 2 2 2 2 2 2 2 2 2 2 2 317 318 2 2 2 2 2 2 2 2 2 2 2 317 318 2 2 2 2 2 2 2 2 2 2 2 2 2 2 2 2 2 2 2 2 2 2 2 2 2 2 2 2 2 2 2 2 2 2 2 2 2 2 2 2 2 2 2 2 2 2 2 2 2 267 268 2 2 2 2 2 2 279 333 333 333 333 333 333 
333 333 333 333 333 290 2 2 2 2 2 2 2 2 2 2 2 2 2 2 2 2 2 2 2 2 2 2 2 2 2 2 2 2 2 2 2 2 2 2 2 2 2 2 2 2 2 2 2 2 2 2 2 2 2 2 2 2 2 2 2 2 2 2 2 2 2 2 2 2 2 2 2 2 2 2 2 2 2 2 2 2 2 2 2 317 318 2 2 2 2 2 2 279 333 333 333 333 333 333 
333 333 333 333 333 290 2 2 2 257 258 2 2 2 2 2 2 2 2 2 2 2 2 2 2 2 2 2 2 2 2 2 2 2 2 2 2 2 2 2 2 2 2 2 2 2 2 2 2 2 2 2 2 2 2 2 2 2 2 2 2 2 2 2 2 2 2 2 2 2 2 2 2 2 2 2 2 2 2 2 2 2 2 2 2 2 2 2 2 2 2 2 2 279 333 333 333 333 333 333 
333 333 333 333 333 290 2 2 2 267 268 2 2 2 2 2 2 2 2 2 2 2 2 2 2 2 2 257 258 2 2 2 2 2 2 2 2 2 2 2 2 2 2 2 2 2 2 2 2 2 2 2 2 2 2 2 2 2 2 2 2 2 2 2 2 2 2 2 2 2 2 2 2 2 2 2 2 2 2 2 2 2 2 2 2 2 2 2 2 2 2 2 2 279 333 333 333 333 333 333 
333 333 333 333 333 290 2 2 2 317 318 2 2 2 2 2 2 2 2 2 2 2 2 2 2 2 2 267 268 2 2 2 2 2 2 2 2 2 2 2 2 2 2 2 2 2 2 2 2 2 2 2 2 2 2 2 2 2 2 2 2 2 2 2 2 2 2 2 2 2 2 2 2 2 2 2 2 2 2 2 2 2 2 2 2 2 2 2 2 2 2 2 2 279 333 333 333 333 333 333 
333 333 333 333 333 290 2 2 2 2 2 2 2 2 2 2 2 2 2 2 2 2 2 2 2 2 2 317 318 2 2 2 2 2 2 2 2 2 2 2 2 2 2 2 2 2 2 2 2 2 2 2 2 2 2 2 2 2 2 2 2 2 2 2 2 2 2 2 2 2 2 2 2 257 258 2 2 2 2 2 2 2 2 2 2 2 2 2 2 2 2 2 2 279 333 333 333 333 333 333 
333 333 333 333 333 290 2 2 2 2 2 2 2 2 2 2 2 2 2 2 2 2 2 2 2 2 2 2 2 2 2 2 2 2 2 2 2 2 2 2 2 2 2 2 2 2 2 2 2 2 2 2 2 2 2 2 2 2 2 2 257 258 2 2 2 2 2 2 2 2 2 2 2 267 268 2 2 2 2 2 2 2 2 2 2 2 2 2 2 2 2 2 2 279 333 333 333 333 333 333 
333 333 333 333 333 290 2 2 2 2 2 2 2 2 2 2 2 2 2 2 2 2 2 2 2 2 2 2 2 2 2 2 2 2 2 2 2 2 2 2 2 2 2 2 2 2 2 2 2 2 2 2 2 2 2 2 2 2 2 2 267 268 2 2 2 2 2 2 2 2 2 2 2 317 318 2 2 2 2 2 2 2 2 2 2 2 2 2 2 2 2 2 2 279 333 333 333 333 333 333 
333 333 333 333 333 290 2 2 2 2 2 2 2 2 2 2 2 2 2 2 2 2 2 2 2 2 2 2 2 2 2 2 2 2 2 2 2 2 2 2 2 2 2 2 2 2 2 2 2 2 2 2 2 2 2 2 2 2 2 2 317 318 2 2 2 2 2 2 2 2 2 2 2 2 2 2 2 2 2 2 2 2 2 2 2 2 2 2 2 2 2 2 2 279 333 333 333 333 333 333 
333 333 333 333 333 290 2 2 2 2 2 2 2 2 2 2 2 2 257 258 2 2 2 2 2 2 2 2 2 2 2 2 257 258 2 2 2 2 2 2 2 2 2 2 2 2 2 2 2 2 2 2 2 2 2 2 2 2 2 2 2 2 2 2 2 2 2 2 2 2 2 2 2 2 2 2 2 2 2 2 2 2 2 2 2 2 2 2 2 2 2 2 2 279 333 333 333 333 333 333 
333 333 333 333 333 290 2 2 2 2 2 2 2 2 2 2 2 2 267 268 2 2 2 2 2 2 2 2 2 2 2 2 267 268 2 2 2 2 2 2 2 2 2 2 2 2 2 2 2 2 2 2 2 2 2 2 2 2 2 2 2 2 2 2 2 2 2 2 2 2 2 2 2 2 2 2 2 2 2 2 2 2 2 2 2 2 2 2 2 2 2 2 2 279 333 333 333 333 333 333 
333 333 333 333 333 290 2 2 2 2 2 2 2 2 2 2 2 2 317 318 2 2 2 2 2 2 2 2 2 2 2 2 317 318 2 2 2 2 2 2 2 2 2 2 2 2 2 2 2 2 2 2 2 2 2 2 2 2 2 2 2 2 2 2 2 2 2 2 2 2 2 2 2 2 2 2 2 2 2 2 2 2 2 2 2 2 2 2 2 2 2 2 2 279 333 333 333 333 333 333 
333 333 333 333 333 290 2 2 2 2 2 2 2 2 2 2 2 2 2 2 2 2 2 2 2 2 2 2 2 2 2 2 2 2 2 2 2 2 2 2 2 2 2 2 2 2 2 2 2 2 2 2 2 2 2 2 2 2 2 2 2 2 2 2 2 2 2 2 2 2 2 2 2 2 2 2 2 2 2 2 2 2 2 2 2 2 2 2 2 2 2 2 2 279 333 333 333 333 333 333 
333 333 333 333 333 290 2 2 2 2 2 2 2 2 2 2 2 2 2 2 2 2 2 2 2 2 2 2 2 2 2 2 2 2 2 2 2 2 2 2 2 2 2 2 2 2 2 2 2 2 2 2 2 2 2 2 2 2 2 2 2 2 2 2 2 2 2 2 2 2 2 2 2 2 2 2 2 2 2 2 2 2 2 2 2 2 2 2 2 2 2 2 2 279 333 333 333 333 333 333 
333 333 333 333 333 290 2 2 2 2 2 2 2 2 2 2 2 2 2 2 2 2 2 2 2 2 2 2 2 2 2 2 2 2 2 2 2 2 2 193 2 2 2 2 2 2 2 2 195 2 2 2 2 2 2 2 2 2 2 2 2 2 2 2 2 2 2 2 2 2 2 2 2 2 2 2 2 2 2 2 2 2 2 2 2 2 2 2 2 2 2 2 2 279 333 333 333 333 333 333 
333 333 333 333 333 290 273 273 273 273 273 273 273 273 273 273 273 273 273 273 273 273 273 273 273 273 273 273 273 273 273 273 273 273 273 273 273 273 273 273 273 273 273 273 273 273 273 273 273 273 273 273 273 273 273 273 273 273 273 273 273 273 273 273 273 273 273 273 273 273 273 273 273 273 273 273 273 273 273 273 273 273 273 273 273 273 273 273 273 273 273 273 273 273 333 333 333 333 333 333 
333 333 333 333 333 333 333 333 333 333 333 333 333 333 333 333 333 333 333 333 333 333 333 333 333 333 333 333 333 333 333 333 333 333 333 333 333 333 333 333 333 333 333 333 333 333 333 333 333 333 333 333 333 333 333 333 333 333 333 333 333 333 333 333 333 333 333 333 333 333 333 333 333 333 333 333 333 333 333 333 333 333 333 333 333 333 333 333 333 333 333 333 333 333 333 333 333 333 333 333 
333 333 333 333 333 333 333 333 333 333 333 333 333 333 333 333 333 333 333 333 333 333 333 333 333 333 333 333 333 333 333 333 333 333 333 333 333 333 333 333 333 333 333 333 333 333 333 333 333 333 333 333 333 333 333 333 333 333 333 333 333 333 333 333 333 333 333 333 333 333 333 333 333 333 333 333 333 333 333 333 333 333 333 333 333 333 333 333 333 333 333 333 333 333 333 333 333 333 333 333 
333 333 333 333 333 333 333 333 333 333 333 333 333 333 333 333 333 333 333 333 333 333 333 333 333 333 333 333 333 333 333 333 333 333 333 333 333 333 333 333 333 333 333 333 333 333 333 333 333 333 333 333 333 333 333 333 333 333 333 333 333 333 333 333 333 333 333 333 333 333 333 333 333 333 333 333 333 333 333 333 333 333 333 333 333 333 333 333 333 333 333 333 333 333 333 333 333 333 333 333 
333 333 333 333 333 333 333 333 333 333 333 333 333 333 333 333 333 333 333 333 333 333 333 333 333 333 333 333 333 333 333 333 333 333 333 333 333 333 333 333 333 333 333 333 333 333 333 333 333 333 333 333 333 333 333 333 333 333 333 333 333 333 333 333 333 333 333 333 333 333 333 333 333 333 333 333 333 333 333 333 333 333 333 333 333 333 333 333 333 333 333 333 333 333 333 333 333 333 333 333 
333 333 333 333 333 333 333 333 333 333 333 333 333 333 333 333 333 333 333 333 333 333 333 333 333 333 333 333 333 333 333 333 333 333 333 333 333 333 333 333 333 333 333 333 333 333 333 333 333 333 333 333 333 333 333 333 333 333 333 333 333 333 333 333 333 333 333 333 333 333 333 333 333 333 333 333 333 333 333 333 333 333 333 333 333 333 333 333 333 333 333 333 333 333 333 333 333 333 333 333
